#Linha#Coluna#
10#10#
167,119,136,202,172,123,116,120,152,147,
276,256,306,385,294,251,141,218,206,210,
220,237,299,346,245,235,144,228,200,233,
181,125,190,237,194,221,115,179,145,151,
155,137,153,228,192,150,113,131,144,156,
280,257,299,376,285,285,129,268,228,225,
293,257,261,372,304,241,174,265,225,256,
241,140,172,243,260,213,133,209,204,202,
274,194,219,357,326,223,153,175,232,245,
130,121,161,211,172,138,84,98,105,129,
