#Linha#Coluna#
10#10#
6,2,12,14,4,14,2,0,6,0,
18,16,2,18,16,14,0,12,16,2,
12,2,2,14,14,14,14,10,14,12,
16,2,14,8,16,2,4,4,6,14,
4,6,10,6,8,10,4,10,4,4,
12,16,6,18,14,4,12,8,16,12,
4,12,14,18,6,14,4,10,18,12,
4,6,18,18,16,6,8,0,0,16,
6,18,16,16,0,10,6,18,2,6,
10,6,2,4,8,8,2,14,2,6,
