#Linha#Coluna#
15#22#
11,11,12,10,10,10,10,13,9,2,16,6,13,12,6,14,15,8,5,15,11,8,
12,9,11,2,4,5,6,5,5,1,7,9,1,11,12,13,15,12,9,13,9,6,
8,9,10,6,8,7,3,12,10,17,14,11,12,11,9,2,6,4,3,17,5,6,
9,8,4,6,13,7,2,4,14,13,5,7,11,13,5,4,8,7,4,5,11,10,
8,12,12,6,10,9,6,10,7,5,8,16,13,5,6,9,13,15,4,9,2,7,
15,9,6,17,10,14,4,5,6,4,12,11,13,4,14,11,4,6,8,8,4,14,
3,3,15,2,10,1,3,13,2,2,6,11,1,0,7,9,8,4,7,10,10,12,
6,6,16,14,12,6,14,2,12,11,7,10,13,10,3,9,5,8,2,13,10,7,
7,11,7,7,10,16,10,0,11,8,8,9,14,14,9,10,10,4,5,7,4,10,
9,12,2,6,10,7,10,4,4,9,8,3,8,9,4,10,13,7,12,4,8,8,
10,9,4,2,3,9,14,10,11,13,4,16,10,7,3,14,5,9,8,13,16,8,
6,4,12,10,14,6,7,4,8,11,6,12,6,10,3,10,4,16,5,9,14,7,
10,10,15,5,11,5,4,11,7,10,16,11,15,10,7,4,18,7,7,5,1,5,
10,6,7,8,14,15,18,11,6,2,13,5,11,7,10,7,11,9,9,7,10,7,
2,1,15,11,12,6,8,15,11,12,11,14,12,11,9,4,14,18,9,10,3,12,
